
2 3 5 4 3 2 4 2 1 8 7 7 3 1 7 3 9 3 5 5 
9 2 5 4 7 6 1 2 7 4 3 7 5 9 8 7 6 4 2 1 
4 2 2 7 1 9 5 7 4 8 6 7 3 3 7 9 1 8 5 3 
4 3 2 9 9 2 1 7 1 3 5 7 6 4 8 7 3 1 5 5 
2 8 5 9 9 2 1 2 9 3 7 1 4 9 4 6 4 9 4 4 
7 2 5 7 6 6 9 5 1 3 1 6 7 2 9 9 1 3 9 6 
2 9 8 1 3 4 5 6 3 3 5 4 3 6 8 8 7 2 9 7 
3 6 4 5 2 9 9 7 7 4 4 8 3 1 8 7 6 8 4 2 
9 8 4 9 9 7 1 8 2 2 1 2 9 4 2 1 1 3 3 8 
6 9 9 4 7 1 4 7 4 9 6 1 5 9 7 3 5 8 9 4 
4 4 4 7 1 7 3 1 9 2 4 1 8 2 2 7 4 2 8 2 
8 2 4 4 8 3 8 6 1 2 5 5 4 2 8 8 4 5 3 8 
1 5 4 1 2 1 4 9 2 9 8 1 9 1 8 2 9 3 4 9 
8 4 7 7 2 4 3 3 1 6 8 9 4 4 5 4 3 5 4 6 
4 4 3 5 3 2 3 8 9 4 1 8 7 1 8 4 6 9 9 6 
9 2 9 5 1 6 9 8 5 2 9 2 6 8 7 9 9 6 7 6 
3 3 4 4 9 7 8 4 5 8 7 7 7 2 2 4 8 4 6 9 
8 7 8 4 5 9 9 7 1 3 6 4 8 5 2 7 1 2 7 7 
3 2 2 4 2 8 6 3 7 4 3 3 6 4 9 1 3 9 7 5 
5 4 8 2 3 7 6 8 9 9 1 5 6 9 5 8 7 6 6 5 