
4 5 8 9 4 4 4 2 9 4 8 0 6 0 1 6 3 9 4 7 5 2 7 4 4 0 8 3 7 9 
7 4 7 4 5 0 3 4 0 6 1 5 9 7 8 5 3 4 6 4 7 0 9 1 7 6 5 4 9 9 
8 5 4 7 1 2 6 10 3 6 2 1 6 1 6 6 4 1 3 3 7 7 6 7 10 2 5 3 6 8 
3 6 4 10 6 5 2 2 8 9 5 8 7 10 7 1 1 0 9 2 5 0 1 1 10 7 0 1 2 6 
4 1 6 0 4 1 2 2 10 2 0 1 1 5 9 2 4 9 8 9 2 10 5 3 8 1 9 9 8 1 
8 9 2 5 10 7 10 0 9 4 6 6 7 6 10 3 7 5 2 9 10 2 6 9 2 6 3 0 3 10 
6 5 0 6 8 8 10 8 9 0 3 3 10 5 4 2 8 9 5 0 3 9 1 7 2 10 3 4 4 0 
4 10 10 9 9 7 8 9 2 0 5 9 4 7 10 9 3 10 0 10 8 4 2 8 7 6 5 7 1 0 
8 3 1 8 9 9 10 5 10 0 7 7 2 6 8 8 0 3 0 6 0 0 7 4 2 10 8 5 6 0 
4 1 9 6 2 10 1 8 1 10 10 6 4 6 6 10 7 5 4 7 6 8 10 7 0 0 10 8 3 5 
10 8 6 1 6 9 0 1 9 9 0 2 10 10 8 0 4 0 7 1 3 7 7 2 1 2 5 4 7 10 
1 5 9 6 10 4 10 6 9 6 4 10 4 7 5 5 0 10 3 3 7 9 7 3 8 5 10 1 10 8 
3 1 10 8 9 5 6 0 10 2 1 10 5 8 7 9 7 2 7 8 8 0 0 9 5 7 9 1 10 3 
2 8 10 3 6 1 3 10 10 2 7 2 5 9 2 10 1 5 5 6 1 5 0 7 6 1 3 3 6 4 
6 7 2 10 2 4 5 6 3 1 8 0 3 8 4 8 7 8 7 7 1 6 5 9 6 1 1 9 0 4 
4 3 9 5 10 6 10 3 9 8 4 8 10 2 3 0 2 3 9 7 8 4 8 8 10 6 1 2 4 10 
4 8 7 9 1 9 10 4 9 8 6 7 2 3 3 5 9 5 9 3 2 7 7 7 8 10 10 8 1 7 
6 6 9 2 4 8 9 9 6 7 2 8 2 9 8 6 7 4 3 5 3 8 8 1 6 7 7 8 5 7 
3 4 9 0 1 0 9 2 10 4 10 0 4 0 9 9 7 1 2 10 0 9 3 1 9 2 1 7 4 5 
1 7 7 3 3 5 2 7 10 1 9 6 5 4 8 10 7 3 5 4 6 9 6 8 3 8 10 2 2 5 
8 3 7 9 5 6 4 5 1 3 5 0 8 6 1 10 10 7 7 8 3 3 1 10 0 9 0 8 4 6 
3 4 10 8 2 6 10 2 8 2 10 4 3 7 9 10 4 3 2 7 3 10 1 1 5 8 5 10 7 2 
10 1 10 9 7 5 8 3 1 10 4 1 4 0 9 8 0 5 3 3 7 3 1 5 9 6 4 3 8 8 
6 7 3 5 5 2 9 2 8 1 6 3 9 2 2 2 10 2 8 8 4 3 2 2 6 0 8 8 8 7 
3 8 4 8 7 10 8 4 5 4 9 1 4 9 0 7 10 4 1 4 7 9 4 5 5 6 1 1 7 4 
7 9 7 9 1 6 6 7 3 0 7 8 6 7 5 2 5 6 4 6 3 6 7 2 7 10 9 5 1 10 
3 3 4 3 10 8 4 10 1 5 7 3 10 7 1 9 5 10 1 10 0 4 8 1 10 9 2 2 8 0 
1 1 2 2 4 7 3 8 1 2 4 6 2 5 4 4 4 8 3 7 1 8 5 3 1 0 0 6 7 2 
6 10 3 9 5 7 8 7 3 0 6 3 9 4 8 4 10 6 1 1 4 3 0 4 3 9 8 0 8 4 
10 3 8 9 8 9 5 5 6 2 5 8 3 5 7 6 5 4 4 3 10 8 2 10 4 0 6 6 3 6 